新幹線駅舎    観光センター内
総合体育館	事務室
林業センター	事務室
長万部小学校	職員室
長万部町福祉センター	１階ロビー（事務室前）
長万部町役場	１階ホール
長万部中学校	職員室
静狩小学校	職員室
長万部町老人福祉センター	１階ロビー（玄関付近）
北海道七飯高等学校	１階職員玄関/２階会議室前廊下
北海道立漁業研修所	寄宿舎（海友寮）
森町立石倉小学校	職員玄関入口
北海道森高等学校	職員室/体育教官室
森町立森幼稚園	職員室
森町展望物産館プラザ	１Ｆロビー
森町立尾白内保育所	事務室
森町立尾白内小学校	職員室
森町立森保育所	事務室
森町民体育館	事務室
森町民体育館サン・ビレッジ森	事務室
森町立森小学校	体育館入口
森町立駒ヶ岳小学校	職員室
森町緑地等管理中央センター駒ヶ峯温泉ちゃっぷ林館	事務室
森町立さわら幼稚園	職員室
森町砂原公民館	１Ｆホール
森町立さわら小学校	職員玄関入口
森町砂原支所	１Ｆロビー
森町立砂原中学校	職員室
森町立新川保育所	職員室
森町立鷲ノ木小学校	職員室
森町立濁川小学校	職員室
森町立濁川保育所	遊戯室
森町発達支援事業センター「あいあいクラブ」	事務室
森町立鷲ノ木保育所	職員室
森町まちの駅	１Ｆ事務室
森町立港町保育所	職員室
森町公民館	１Ｆ事務室
森町役場	正面玄関入口
森町交流支援センター	事務室
森町保健センター	事務室
木古内町中央公民館	１階玄関入口
木古内町立木古内中学校	１階校長室
木古内町健康管理センター	１階事務室
木古内町役場	１階ホール
木古内町立木古内小学校	２階職員室
木古内町介護老人保健施設いさりび	１階事務室
久根別体育センター	事務室
久根別住民センター	1階ホール
しかべ間欠泉公園	受付・お客様通路間
いこいの湯	1階ロビー
渡島リハビリテーションセンター診療所	第1診療所
渡島信用金庫鹿部支店	窓口付近
本別中央会館	1階管理室
鹿部ロイヤルホテル	フロント
鹿部町総合体育館	１階アリーナ入口
鹿部町立鹿部中学校	1階職員室
鹿部町役場	1階玄関ホール
しかべ幼稚園	1階遊戯室入口
鹿部中央公民館	1階事務室
鹿部町立鹿部小学校	1階職員室前廊下
鹿部町山村広場コミュニティセンター	受付横
知内町立知内小学校	職員室
知内町中央公民館	ロビー
知内町立知内中学校	保健室
知内町保健センター	ロビー
知内町立知内高等学校	保健室
知内町立湯ノ里小学校	ロビー
知内町立涌元小学校	体育館
石別住民センター	事務室
保健センター	事務室前
大沼小学校	職員室
大沼中学校	職員室
軍川小学校	職員室
峠下小学校	職員室
東大沼小学校	職員室
藤城小学校	職員室
大中山小学校	職員室
大中山中学校	職員室
北海道七飯養護学校	寄宿舎舎務室
七飯町役場	1階ホール/2階総務課/3階議会事務局/他10個
七重小学校	職員室
七飯中学校	職員室
浜分体育センター	事務室
八雲地方合同庁舎	2階税務署窓口カウンターの上（棚）
八雲町立図書館	事務室
函館公園	ﾋﾞｼﾞﾀｰｾﾝﾀｰ研修室前
青函フェリー函館ターミナル	1階受付窓口
北海道函館養護学校	小中職員室前廊下
飯田内科クリニックいしかわ　デイケアいしかわ	デイケア1階相談室
北海道函館稜北高等学校	３階物理教室前廊下/１階事務室前廊下/トイレシャワー室渡廊下
福）侑愛会函館青年寮	職員玄関
北海道大学北方生物圏フィールド科学センター臼尻水産実験所	実験棟2階正面玄関内
縄文文化交流センター	正面入口受付付近
株式会社 はこせき　大川町サービスステーション	サービスルーム内
ＮＴＴ東日本ー北海道設備部　函館設備部門	1階玄関入って右
日本生命保険相互会社　函館支店	1階お客様来店窓口
えさん漁業協同組合	2階事務所入口
戸井漁協共同組合（小安支所）	事務所内
函館港湾福利厚生会館	1階事務所内
株式会社北海道日水	函館事業所入口1階
函館港湾合同庁舎	1階エレベーターホール/5階エレベーターホール
函館開発建設部　函館港湾事務所	事務所内1階玄関横
函館大学付属柏稜高等学校	職員玄関入口廊下/石川総合グランド管理棟
北海道南茅部高等学校	職員玄関/体育館
戸井漁協共同組合（本所）	事務所内
函館地方検察庁	1階受付
函館地方合同庁舎	1階ロビー
公立はこだて未来大学	ロビー
道南四季の杜公園	管理事務所受付
清尚学院高等学校	事務室/体育館
グループホームのぞみ２号館	1階事務室
南かやべ漁業協同組合直販加工センター	直売店 海側出入口
北海道函館工業高等学校	１階柏ケ丘ホール玄関/１階職員玄関/２階体育館職員室前/２階実習棟渡廊下
向山歯科桔梗クリニック	院内
函館高等技術専門学院	１階事務室カウンター
函館三育小学校	教員室内
中央図書館	1階開架コーナー総合カウンター向かい
株式会社ほくせん　ハコセン事業部	1階　窓口
北海道立函館美術館	受付カウンター
北海道函館五稜郭支援学校	１階玄関ホール内
北海道函館商業高等学校	定時制職員室/全日制職員室（養護教諭席）/体育教官室
パチンコ　ボンボン	ホール内 カウンター前
ロイヤル函館店	景品カウンター
昭和公園	中央広場　休憩施設
救護施設　函館共働宿泊所救護部	1階地域交流スペース
遺愛女子中学・高等学校	本館1階教務事務室/学校寮
株式会社　高橋組	1階職員玄関内
戸井漁協共同組合（東戸井支所）	事務所内
北海道函館盲学校	職員玄関
青年センター	1階ホール階段登り口
北海道函館中部高等学校	２階職員室前廊下/１階職員玄関前/２階体育館前
ホーマック株式会社スーパーデポ湯川店	サービスカウンター内
アフィーテ函館	1階フロント
中島れんばいふれあいセンター	1階フリースペース　玄関入口付近
函館児童相談所	受付カウンター
福）函館共愛会養護老人ホームまろにえ	2階「ゆずりは」ユニット職員室
株式会社クロダリサイクル	1階事務所内
国立大学法人　北海道教育大学教育学部函館校	1階正面玄関内/1階体育館入口/1階福利厚生棟入口
北海道戸井高等学校	１階職員玄関
デイサービスセンター戸井	日常動作訓練室
東山墓園	管理事務所
福）育栄会よつば学園	事務所前廊下
財団法人鉄道弘済会　人見保育所	1階玄関正面エレベーター付近
ＩＮＤＹ函館	ホール内 カウンター
恵山支所	玄関
函館ラ・サール学園	2階職員室/2階新体育館/1階旧体育館
国際空手道連盟極真会館　北海道函館支部　函館本部道場	1階道場内
北海道函館聾学校	保健室
銭亀沢漁業協同組合	事務所玄関
セントラル警備株式会社	本社事務室内
ケアプラザ新函館・よいあすセンター	1階デイサービス内
NTT北海道テレマート株式会社　116函館センタ	1階玄関
㈱デンソーセールス北海道支社函館支店	1階フロント
北海道教育大学附属函館小中学校	1階正面玄関
函館地方気象台	1階玄関ロビー
北海道渡島合同庁舎内渡島総合振興局	１階受付
真宗大谷派函館別院	1階庶務室
北海道函館西高等学校	職員室/グラウンド/体育教官室
望楼ＮＯＧＵＣＨＩ函館	1階 ロビー フロント横
野口観光マネジメント株式会社　湯元　啄木亭	1階 ロビー フロント前
函館大学付属有斗高等学校	1階事務窓口前/見晴グランド管理棟
函館西警察署函館駅前交番	事務室
スマイルホテル函館	フロントバック
農業振興センター	1階ホール
道立公園噴火湾パノラママーク	パノラマ館/ふれあい館
北海道熊石高等学校	１階廊下/２階廊下
北海道八雲高等学校	１階保健室/１階職員玄関
北海道八雲養護学校	保健室
北斗市役所	保健福祉課内
北海道七飯養護学校おしま学園分校	１階事務室
総合文化センター	事務室
北海道上磯高等学校	２階職員室前廊下/体育館前廊下
七重浜支所	事務室
北海道函館水産高等学校	職員室/体育館廊下/艇庫
北海道大野農業高等学校	２階職員室/寄宿舎１階事務室
茂辺地住民センター	事務室
第二市民プール	事務室
スポーツセンター	事務室
総合分庁舎	事務室
公民館	1階ロビー
せせらぎ温泉	事務室
福島町活性化センター（あづま～る）	多目的室
福島町吉岡支所	事務室
福島中学校	職員室
福島町福祉センター	事務室
福島小学校	職員室
横綱千代の山・千代の富士記念館	１階ロビー
福島町役場	１階ロビー
北海道福島商業高等学校	２階職員室
福島町総合体育館	事務室
青函トンネル記念館	１階ロビー
認定こども園福島保育所	事務室
吉岡小学校	職員室
吉岡温泉（ゆとらぎ館）	事務室
松前町町民総合センター	体育館事務室
北海道松前高等学校	１階生徒玄関ホール内/職員室
松前温泉休養センター	事務室
松前町役場	宿直室
茂辺地体育センター	事務室
北海道立青少年体験活動支援施設ネイパル森	玄関前ロビー
噴火湾パノラマパーク	パノラマ館受付カウンター/ふれあい館受付
森警察署	１階電話交換室
石別中学校	職員室
市渡小学校	職員室
沼っ子クラブ	事務室
あおぞらクラブ	学童専用室内
サルビアクラブ	事務室
大沼婦人会館	事務室横
東大沼多目的グランド	クラブハウス内
大中山パークゴルフ場	事務所内
大川コミュニティセンター	事務室横
大中山コモン	事務室横
本町パークゴルフ場	事務所内
本町多目的グランド	ハウス内
七飯町スポーツセンター	事務所内
七飯町文化センター	事務室内
松前町交流の里づくり館	事務室
江良町民体育館	事務室前廊下
松前町立大島小学校	職員室前廊下
松前町ふれあい公園パークゴルフ場	事務室
松前町民野球場	本部席
松前町立松城小学校	体育館前廊下
松前警察署	１階署長室
松前町立小島小学校	体育館側玄関
松前町立大島中学校	職員室
松前町立松前中学校	体育館前廊下
木古内警察署	１階事務室
沖川小学校	職員室
ひまわりクラブ	事務室
上磯小学校	職員室
上磯中学校	職員室
浜分小学校	職員室
浜分中学校	職員室
久根別小学校	職員室
石別小学校	職員室
介護老人保健施設コミュニティホーム八雲	ステーション
社会福祉法人立栄会　ケアハウスひまわり・なのはな	地域交流スペース
おぼこレクリエーションセンター	廊下
独立行政法人国立病院機構 八雲病院	正面玄関（フロア内トイレの手前）
八雲町立熊石第一中学校	玄関ホール
八雲町熊石国民健康保険病院	ナースステーション
八雲町雲石小学校	玄関ホール
八雲町立関内小学校	体育館
八雲町役場熊石総合支所	1階　フロア
八雲町熊石第二中学校	玄関ホール
八雲町立相沼小学校	職員室
八雲町立泊川小学校	玄関ホール
温泉ホテル八雲遊楽亭　ひらたない荘	あわびの湯　入口
八雲町立黒岩小学校	廊下（職員室と玄関の間）
八雲町立山越小学校	職員室
八雲町立山崎小学校	玄関ホール
八雲町役場	ロビー
八雲町立八雲小学校	職員室
八雲町民プール	事務室
株式会社東日本宇佐美八雲サービスステーション	フロア（セールスルーム）棚上
函館開発建設部　八雲道路事務所	事務所一階ロビー
八雲町立八雲中学校	職員室
（有）典礼舎	玄関
八雲総合病院	"防災センター横ロビー
職員玄関エレベーター"
北海電子（株）	事務所前
八雲町立東野小学校	職員室
八雲町漁業協同組合	1階事務室
八雲町立浜松小学校	職員室内
八雲警察署	１階警務課事務室
はぴあ八雲	玄関
渡島信用金庫八雲支店	店内カウンターの上（棚）
docomo八雲店	入り口カウンターの上（棚）
八雲町公民館	玄関
新函館農業協同組合　八雲支店	貯金窓口フロア
八雲町立野田生中学校	玄関ホール
八雲町立野田生小学校	職員室前廊下
新函館農業協同組合　落部支店	事務所出入り口通路
八雲町立落部小学校	玄関ホール
八雲町立落部中学校	職員室
八雲町役場落部支所	事務室
道央自動車道　八雲料金所	事務室
航空自衛隊八雲分屯基地	当直室
市立恵山中学校	1階職員室
函館中央警察署	１階ロビー
市立函館高等学校	保管室/体育館/職員室
市立臼尻小学校	職員室内
南茅部スポーツセンター	1階アリーナ入口
デイサービスセンター花園	デイルーム
テーオーアスレティッククラブ	2階フロント
函館西警察署	１階ロビー
ふ頭管理事務所	事務所内
市立潮光中学校	職員室
戸井支所	玄関
市立亀尾小中学校	1階エントランス
株式会社　松本組	1階総務部内
市立万年橋小学校	職員室
市立桔梗小学校	職員室内
市立中の沢小学校	職員室
市立桔梗中学校	職員室
青果物地方卸売市場	休憩所
市民スケート場	1階事務室内
市立金堀小学校	1階職員室
市立駒場小学校	1階職員室内
重要文化財旧函館区公会堂	1階大食堂
写真歴史館	1階カウンター前
函館山ロープウェイ株式会社	山麓窓口/山頂窓口
旧イギリス領事館	1階展示室内「開港記念ホール」
函館工業高等専門学校	学生玄関ロビー/体育館入口/学生寮入口
市立戸倉中学校	職員室
総合保健センター	1階ロビー/4階健康増進センター
芸術ホール	1階ロビー事務室入口前
五稜郭タワー	1階団体カウンター内/展望台売店内
箱館奉行所	受付横板廊下
市立函館病院高等看護学院	事務室
市立港小学校	1階職員室内
市立港中学校	1階職員室
函館港港町ふ頭コンテナヤード	管理棟
デイサービスセンター港	事務所内
北海道大学水産学部	管理研究棟１階正面玄関/体育館玄関/附属練習船おしょろ丸/うしお丸
市立高丘小学校	職員室
函館大学	保健室/体育館
函館短期大学	1階フィットネスセンター内
函館空港旅客ターミナルビル	1階チェックインロビー/2搭乗者待合室/3階キッズコーナー横　/2階空港ビル事務室
市立高盛小学校	1階職員室
市立光成中学校	職員玄関
恵山シーサイドパークゴルフ場	管理事務所
根崎生活館	集会室
市立北中学校	2階職員室
空港緑地志海苔ふれあい広場	クラブハウス入口付近
ホテル恵風	1階ロビー
ＪＲ北海道函館駅	JR函館駅内
コンフォートホテル函館	1階ロビー
総合福祉センター	センター３階
戸井運動広場	正面玄関
市立戸井西小学校	職員室
市立昭和小学校	職員室
市立北昭和小学校	職員室
市立柏野小学校	職員室
市立上湯川小学校	1階職員室
市立中部小学校	1階職員室内
市立椴法華小学校	１階職員室内
市立椴法華中学校	職員室
椴法華総合センター	1階ﾛﾋﾞｰ階段登り口壁面
椴法華高齢者福祉総合センター	1階集会室
市立深堀小学校	1階職員室内
市立深堀中学校	職員室
函館ひかり幼稚園	1階玄関
市立神山小学校	１階職員室
市立旭岡小学校	1階職員室内
市立旭岡中学校	1階職員室
西桔梗野球場	管理棟内
市立潮見中学校	職員室内
公民館	事務室　
市立青柳小学校	1階職員室内
市立石崎小学校	1階職員室内
函館運転免許試験場	１階事務室
ケアセンターらいふ赤川	ショートステイ1階医務室内
市立赤川中学校	職員室
市立赤川小学校	1階職員室内
市立千代ヶ岱小学校	職員室
サン・スポーツクラブ	1階コーチ室
千代台公園陸上競技場	1階事務室入口
市民プール	25mプール入口/50mプール棟入口
千代台公園野球場	1階事務所入口
市立凌雲中学校	職員室内
千代台公園庭球場	クラブハウス1階
千代台公園弓道場	1階事務室前
南茅部支所	１階ロビー
恵山総合体育館	1階ホール
函館酸素株式会社	事務所1階入口付近
原工業株式会社	1階タイムカード室
斎場	1階事務所
銭亀沢支所	1階
市立東小学校	1階職員室
函館男爵倶楽部ホテルアンドリゾーツ	1階フロントバックヤード
株式会社東横イン函館駅前朝市	1階ロビー
ホテルポルト函館	1階事務所内
勤労者総合福祉センター	センターアリーナ入口前
市立宇賀の浦中学校	1階職員室入口
市立あさひ小学校	体育館男子更衣室
市立大川中学校	職員玄関前
国土交通省北海道開発局函館開発建設部	1階ロビー
市立北星小学校	1階保健室
すずらんの丘公園パークゴルフ場	管理事務所
谷地頭老人福祉センター	1階事務室
青少年研修センター	1階ロビー
スポーツクラブ　ルネサンス函館	2階　フロントカウンター横
市立鍛神小学校	職員室
市立中島小学校	1階職員室内
函館税務署	2階総務課
市立えさん小学校	１階職員室
市立的場中学校	職員室
市立五稜中学校	１階事務室
函館若葉幼稚園	1階職員室
市役所	1階市民ホール
市立東山小学校	2階職員室
女性センター	2階事務室
市民会館	管理棟1階玄関付近
市民体育館	１階事務室前/４階廊下奥
湯川老人福祉センター	1階事務室
はこだて療育・自立支援センター	1階
湯川支所	1階ロビー
市立湯川中学校	職員室
熱帯植物園	温室内管理事務所
公益社団法人　函館市医師会	1階ロビー
市立湯川小学校	職員室
根崎公園ラグビー場	クラブハウス内
市立日吉が丘小学校	職員室
市立北日吉小学校	職員室
日吉サッカー場	管理棟1階ホール
恵山福祉センター	事務室前廊下
市立日新中学校	職員室前
白石公園はこだてオートキャンプ場	センターハウス多目的ホール
市立八幡小学校	保健室
南茅部プール	1階事務室
市立磨光小学校	１階職員室内
南茅部斎場	1階待合ホール
市立尾札部中学校	職員室
亀田福祉センター	1階ロビー階段登り口
亀田支所	１階ロビー
美原老人福祉センター	1階事務室
市立中央小学校	職員室
市立亀田中学校	職員室
市立桐花中学校	職員室
市立亀田小学校	職員室
亀田公民館	1階事務室
市立日新小学校	職員室
市立銭亀沢中学校	職員室内
市立臼尻中学校	職員室
水産物地方卸売市場	本棟卸売場休憩所
市立北美原小学校	2階職員室
ドーミーイン函館五稜郭	2Fエレベーター横
市立本通小学校	職員室内
市立本通中学校	職員室前
市立南本通小学校	２階職員室内
市立鱒川小中学校	1階職員室
金森赤レンガ倉庫	函館ビヤホール/ＢＡＹはこだてインフォメーション
北方民族資料館	1階正面入口付近
株式会社エスイーシー	本社ビル1階ホール
文学館	１階受付前
地域交流まちづくりセンター	1階正面入口
企業局庁舎	企業局1階ホール入口
市立西中学校	１階職員室前廊下
市立弥生小学校	1階職員室内
市立千代田小学校	1階職員室
函館エヌ・デー・ケー株式会社	1階A棟前休憩コーナー/1階G棟前/2階食堂
谷川小学校	職員室
大野小学校	職員室
たんぽぽクラブ	事務室
大野中学校	職員室
茂辺地小中学校	職員室